@.###################
....#.........#.#...#
###.#########.#.###.#
#.......#.....#.....#
#.###.#####.#####.#.#
#...#.#.......#...#.#
###.#.#.###.###.###.#
#...#.....#.#...#...#
###.###.#.#####.#####
#.#...#.#...#.#...#.#
#.#######.#.#.###.#.#
#.......#.#.#.#.....#
#.#####.#.###.#.###.#
#.....#...#.#...#...#
#.#.###.#.#.#.#.###.#
#.#.#...#.....#...#.#
###.###.#.#######.###
#.....#.#.#...#.#.#.#
#.#####.###.#.#.#.#.#
#.....#.....#.#.....#
###################.$