######### #
#  # ###  #
# A   # # #
# # # # # #
# #       #
#   # # #  
# # # # B #
######### #