$.###################################################################################################
..........#.#.....#.....#.......#...........#.#...#.....#.#.#.....#.#...#...#...#.........#.....#.#.#
#####.#.###.#.#.###.#.#####.#####.#.#.#.#####.#.###.#.###.#.#.###.#.#.#####.#.#.#.#.#.#.#####.###.#.#
#.#.#.#...#...#...#.#.......#.....#.#.#.............#.#.#.#.#...#.............#...#.#.#.....#.......#
#.#.#.###.###.###.#.#.###############.#######.#.#.#####.#.#.###.#######.#.###.###.#####.#.#########.#
#...#...#...#...#.#.#.#...#.#.#...#.......#.#.#.#.#...#.#.#.......#.....#.#.#...#.#.....#...#.#.....#
###.#.#.#######.#.###.#.###.#.###.#.#.#####.#.###.###.#.#.#.###########.###.#.#####.###.#####.#.#.###
#.....#.#...#...#...#.........#.....#...#...#...#...#...........#.#...#.....#...#...#.........#.#...#
#.###.###.#####.###.#####.###.#.#.###.#.#.#.#######.#.###.#######.###.#.#.#.#####.###.###.#.###.#####
#.#.............#.....#.#...#...#.#...#...#.#.#.....#.#...#.......#.....#.#...#...#...#...#.#.......#
#.###.###.#####.#####.#.###.#.###############.#.#####.#.#######.#.#.###########.#######.#######.###.#
#.#.....#...#.#...#.........#.#.#...#.............#.#.#.#.#...#.#.#...#.....#.......#.......#...#.#.#
#######.#####.###.#.###.#######.###.#.###.#.###.#.#.#.#.#.###.#.#.###.#####.#.#########.#.###.###.#.#
#...............#.#.#...#...#...#...#.#...#.#...#...#.#.#.....#.#.....#.#.....#.....#...#.#...#.....#
#.#####.#.#############.###.###.#.#.#.#.###.#######.#.#.#.###.#.#.#####.###.###.#.#########.#####.#.#
#.#.....#.....#.#.....#.#.#...#...#...#.#.....#.....#.#.#.#.#.#.#.....#...#.#.#.#.#...#...#.#.....#.#
#############.#.#.###.###.#.#####.#####.###.#.#######.#.#.#.#.#.#.#####.#####.###.###.#.#.###.#.#####
#.........#...#...#...........#...#...#.#...#.#.#.#...#.#.#.....#.#.#.....#.....#.#.#...#.#...#.#...#
#.#####.#.###.#.#.###.#####.#.#.#####.#####.###.#.#####.#######.#.#.###.###.#.###.#.###.###.###.#.###
#.#...#.#.....#.#.#.....#...#.........#.#.....#...#.....#...#...#.#...#.....#.#.......#...#.#.......#
###.#########.###.###.#.#.###.#.#######.#.#######.#######.#######.#.#.#.#.#.#.#.###.#.#.#######.###.#
#.......#.......#...#.#.#.#...#.#...#...#.....#.........#.#.....#...#...#.#.#...#...#.#.#.........#.#
#####.#.#.#######.###.#######.#.#.###.#######.#.#.#.###.#.#.###.#######.#.#####.###.###.#.#######.###
#...#.#.........#.#...#.......#.#.....#.....#...#.#.#.#.......#.....#.#.#.#.#...#...#.....#.#.#.#...#
###.#.#.###.#.#.#.###.#.###.###.#####.#####.#.#.#####.###.#.#########.###.#.#####.#####.###.#.#.###.#
#.#...#.#...#.#.#...#.#.#.....#.........#...#.#.#.#.#...#.#.#...#.#...#.#.#...#.#.#.#.......#...#...#
#.#####.#.###.###################.###.###.#######.#.#.###.#####.#.###.#.###.#.#.#.#.#.#####.#.#.#.#.#
#.#.....#.#.#.#...#.....#.#.......#.#.#.#...#...#.......#.#.#.....#.....#...#.#...#...#.#...#.#...#.#
#.#.#####.#.###.###.#####.#.###.###.#.#.#.#.#.#.#.#########.###.#.#.#######.###.#######.#.###.#.###.#
#...#...#...#.#.#.#.#.#.....#.#.#.#.....#.#.#.#...........#...#.#.#.......#...............#.#.#.#...#
#####.###.###.#.#.#.#.#.#.###.#.#.#.#.#####.###.#########.###.###.#.###.#####.#####.###.###.#######.#
#...................#...#.#...#...#.#...............#.#.#...........#.#.#.......#...#.....#.......#.#
#.#.#.#.#####.#.#.###.###.#.#.###.###.#####.#######.#.#.#.#######.###.#.#.###.###.#######.#.#.###.#.#
#.#.#.#.....#.#.#.#...#.....#...#.#.#.#.....#...#...#.#.#.......#.#...#...#...#.....#...#.#.#.#.#.#.#
#.#####.#############.#####.###.#.#.#.#######.#.#####.#.#####.#####.#.###.###.#######.#.#.#.###.###.#
#.....#.#...#...#.#...#...#...#.#.#.........#.#...#.....#...#.#.#...#.#.#...#.......#.#...#.#.......#
###.###.#.###.###.#.###.###.###.#########.#.#.#######.#.#.#.#.#.###.###.###########.#.###.#.#######.#
#...#.#.......#.#...#.#.#.#...#.#...#...#.#.#.....#...#.#.#.#...#.#.........#...#...#.#.........#...#
###.#.#.#######.###.#.#.#.#####.###.#.#.###.#.#######.#.#.#.#.###.#.###.###.###.###.###.#########.###
#.....#.#...#.................#...#...#...#...#.......#...#.#...#...#.#...#.....#...#.#.#.......#...#
#########.###.###.#.#.#####.#.#####.#######.###.#.#######.#####.#.###.#####.#########.#.#####.#.###.#
#...............#.#.#.#.....#.#.......#.#...#.#.#.......#.#.......#.#.#...#.#.......#.....#...#...#.#
#####.###.#########.###.###.###.###.#.#.#####.#.#####.#.#.###.#####.#.#.#########.#######.#####.#####
#.....#...#...#.....#.....#.#...#...#.#.#.......#.#.#.#.#.........#.........#.#.#...................#
###.#.#######.#.###.#####.#.#.#.#####.#.###.###.#.#.#####.###.###.###.#######.#.#####.#.#####.#.###.#
#.#.#.......#...#.......#.#.#.#.....#.......#...........#.#.....#.#...#...#.#...#.....#...#...#...#.#
#.#.#.###.#.#####.#################.#.#####.#.#####.###############.###.#.#.#.###############.#######
#...#.#.#.#.#.#.#...#...........#...#.#.#...#.#...#.....#...#.....#.....#.....#.....#.#...#...#...#.#
#####.#.#####.#.###.#######.#.#.#.#####.#.#.#.###.###.#####.#####.###.#.###.#######.#.###.###.#.###.#
#.....#...#.......#...#...#.#.#.#.......#.#.#.#.....#.....#...#...#.#.#...#...#...........#...#.....#
###.###.###.###.###.#####.#.###.#.#####.###.###.#######.#####.###.#.###.#####.#.#.###.#.#.#.#.#.###.#
#...#.#.....#.....#.#...#.....#...#.#.#...#.#.....#...#.#.#...............#...#.#.#...#.#...#...#...#
#.#.#.#.#.###.###.###.#.###.###.#.#.#.#.###.#####.###.#.#.###.#########.#.#.#.###.#####.###.#######.#
#.#.....#...#.#...#...#.#.....#.#.....#...#.....#...........#...#.....#.#.#.#...#.....#.#.....#...#.#
#####.#.#####.#####.###########.#########.#############.#####.###.#####.###.#######.#####.#####.#####
#.....#.....#...#.....#.....#.........#.....#.#.#...#...#.#.#.#.#.........#.#.......#.#.#.#.#.#.#...#
#.#######.#.###.###.#.#.###########.###.#.#.#.#.#.#####.#.#.###.#####.#############.#.#.#.#.#.#.#.###
#...#.#...#...#.....#.#.......#...#.#...#.#...#...#.#.......#.#.....#...#...#.#.......#.#...#.......#
#.###.#.#.###.#.#############.###.#######.#####.###.#.#.#####.#####.#.###.###.#.###.#.#.###.#.###.###
#...#...#.#...#...#.........#.....#.#...#...#...#.#...#...#.....#.....#.....#...#...#...#...#.#.#...#
###.###.#.#####.#.###.###.#####.###.###.###.#.###.#.#######.#####.#.###.#######.###.###.###.###.#.###
#...#...#...#.#.#.#...#.#.#.....#...#.....#.#.#...#.......#.#.....#.....#.#.#.....#...#...#...#.....#
###.#########.#.#.#.###.#.#.#####.###.###.###.#.#.#.#.#####.#######.#####.#.#######.#.#.#.#####.#.#.#
#.....#.....#.#.#...#.#...#...#.#...#.#.#.#.#.#.#...#.....#.....#.#...#.#.#...#.#.#.#.#.#.......#.#.#
#####.#.#####.#.###.#.#####.###.#.#####.#.#.#.###.#####.###.#.#.#.#.###.#.###.#.#.###.###.#.#########
#.#...#.......#.#...#...#.....#...#.#...#.#.#.#...#.....#...#.#.......#.#...#.......#...#.#.#.#...#.#
#.###.#.#####.#.###.#.#######.###.#.#.#.#.#.#.#.###.#########.#.#.#.#.#.###.#####.###.#####.#.#.#.#.#
#.....#.#...#...#.....#...#...#.#.....#...#.....#.......#.#...#.#.#.#...#...#...#.........#.....#...#
###.#####.#.#######.#.###.#.#.#.#.#######.#############.#.#.#.###.#.#####.###.#####.###.#######.###.#
#.#.#.#.#.#.....#...#.#...#.#...#.....#.....#.......#.#.#.#.#...#.#.#.#.............#.....#.#...#.#.#
#.###.#.#.#########.#####.###.#####.###.#.###.#.#####.#.#.#########.#.###.###.###.###.#.#.#.#####.#.#
#...#...#.....#.#.#.....#.......#.#.#...#...#.#.#.#.#.#...#.....#.#.#...#.#.#...#.#...#.#...#...#...#
###.#.#.###.#.#.#.#####.#.#.#####.#.#######.#.###.#.#.###.#####.#.#.#.#.###.#.#.#####.#.#.###.#####.#
#...#.#.#...#.........#.#.#...#...#.#.#.........#.#...#.....#.#.......#.#.#...#...#...#.#.#.#...#...#
#.###.###########.#####.#.#######.#.#.#######.###.###.#.#####.#.#.###.###.###.#.#.#####.#.#.#.#.#.###
#...#.#.......#.....#...........#.......#.....#.#.....#...#.....#...#.......#.#.#...#...#.....#.#...#
###.#.###.###.###.#####.#.#########.###.###.###.#.#.###.#.#.#.#######.#.#.###.#.#.#############.#####
#.#.#.#.....#.#.#.#.#.#.#...#...#...#.#.#.......#.#...#.#...#...#.#...#.#.#...#.#.#.....#...#...#...#
#.#.#.#.#.#####.#.#.#.###.#.#.#.#####.###.#####.#####.###.#######.#####.#####.###.#.#####.###.#####.#
#.#...#.#...#.....#.....#.#.#.#.#...#.......#.#...#.........#.#.....#.#.#.......#...#.#.#.#...#...#.#
#.###.#.#######.#######.#.###.#####.#####.###.###.#.#.#####.#.#.#.###.#.#############.#.#.#.#.#.###.#
#...#.......#...#.........#.#.#.........#.....#.....#.....#.....#...#...#.#...#.#...#.....#.#.......#
#.#.#.#.#.#####.#########.#.#.#.#.#.#.###.###.#.#.#####.###.#.#.###.###.#.###.#.#.###.#.###.#.#######
#.#.#.#.#...........#.#.#.....#.#.#.#.......#.#.#...#.#.#...#.#.#...#.......#.#.#.#...#...#.#...#.#.#
#.#########.#.###.###.#.#.#.#.#######.#.#####.###.###.###.#####.#####.###.#.#.#.#.#.#####.#.#####.#.#
#.....#.#...#...#...#...#.#.#.#.#.#...#.#.#.....#.#.#.#.....#.#...#...#.#.#.#.......#.....#.....#.#.#
#####.#.#.#.#####.###.###.#.###.#.#.#####.#####.###.#.#.#.#.#.#########.###.#####.#.#.#.#######.#.#.#
#...#.#.#.#.....#.#.#.....#...#...#.#.........#.#.......#.#.#...#.........#...#...#.#.#.#.....#.#...#
#.###.#.###.#.#.###.#.#.#.#.###.#########.#.#####.#####.#.#####.#########.#.#.#.#.#####.###.###.#.###
#.#.....#...#.#.#.#...#.#.#.........#...#.#.#.........#.#.#.#...#...#...#...#.#.#...#.........#.....#
#.#.#####.###.###.#.###.#####.#######.#.#.#.###.#######.#.#.###.#.#.#.#.#####.###.#.#.###.#######.###
#.........#...#.......#.#...#...#...#.#...#.#...#.....#.#...#.#...#.#.#.#...#.#.#.#.#.#.#.#.........#
#.###.###.#######.#######.###.###.#######.###.###.###.#.#####.#.#.#.#.###.#.###.###.#.#.#####.#####.#
#.#...#.#...#...#.#.#.......#.#.#.....#.............#.#.#.....#.#.#...#.#.#.#.#.....#.#.#.....#.....#
#.#.#.#.#####.###.#.#.#.#.#.###.#.#####.###.#.#######.#.###.#####.#.###.#.#.#.#####.###.#.#.#####.#.#
#.#.#.#.#.#.#.....#.#.#.#.#...#.#.#...#.#...#.#...#.#.#.........#.#...#...#.#.#.#.#...#...#.#.#...#.#
#####.#.#.#.#####.#.###.#######.#.#.#####.#.###.#.#.#####.#####.#.#####.###.#.#.#.#.#########.#####.#
#.......#...#.........#.#.#.#.....#.#.....#.#...#...#.#.....#.#...#.....#...#.....#...........#.....#
#.#######.#######.#####.#.#.#.#####.#####.#.#.#####.#.###.###.###.#.###########.###.###.###.###.###.#
#.........................#...............#.#.#...........#...................#.....#...#.........#.#
###################################################################################################.@